----------------------------------------------
-xxxxxxxxxxxxxxxxxxxxxxxx---------------------
-x----------------------x---------------------
-x-zzzzzzzzzzzzzzzzzzzz-x---------------------
-x-z------------------z-x---------------------
-x-z-------ooooooooooooooooooooooo------------
-x-z-------o----------o----------o------------
-x-z-------o----------o----------o------------
-x-z-------o----------o----------o------------
-x-z-------o----------o----------o------------
-x-z-------p----------p----------p------------
-x-z-------p----------p----------p-------x-z--
-----------p----------p----------p-------x-z--
-----------o----------o----------o-------x-z--
-----------o----------o----------o-------x-z--
-----------o----------o----------o-------x-z--
-----------o----------o----------o-------x-z--
-----------ooooooooooooooooooooooo-------x-z--
--------------------z-x------------------x-z--
--------------------z-xxxxxxxxxxxxxxxxxxxx-z--
--------------------z----------------------z--
--------------------zzzzzzzzzzzzzzzzzzzzzzzz--
----------------------------------------------
----------------------------------------------